BUF,4441898649,0,4758545629,4871757646,555627455,454736472,330319043,1340682970,334363227,314119122,659560472,1308042821,305147915,291712457,627294254,1224154626,385169987,354432468,242752368,982354823,4855235240,4761340648,93894592,1.9720200452,4871757646
CPT,26104779478,0,28436210391,29120624607,2402187795,2771258548,1945429769,7118876112,1999066824,2034654753,3236909198,7270630775,2466377890,2423134885,3261744877,8151257652,2163119417,2252582771,1906734658,6322436846,28863201385,28370984487,492216898,1.7349306233,29120624607
EC101,195911171,0,227262791,234403762,64877825,11128568,8828110,84834503,10345393,12088257,23047527,45481177,10171440,10604203,30472386,51248029,9265659,12776326,8270943,30312928,211876637,227262791,-15386154,-6.7702037506,234403762
EC102,163357691,0,173569620,171823570,35715708,8904843,11145544,55766095,11236755,9904547,23793233,44934535,10419476,10853398,22239565,43512439,10188360,9558168,9656879,29403407,173616476,173569628,46848,0.0269908973,171823570
EC103,38307054,0,43788123,47842244,10476092,739904,910200,12126196,894991,824505,8853634,10573130,1357343,943985,5458820,7760148,795260,2818413,2432717,6046390,36505864,43788137,-7282273,-16.6306984013,47842244
EC104,287696029,0,382010080,382010080,109815874,2315300,16517296,128648470,17204646,34129896,21095035,72429577,45197765,20281972,21095035,86574772,21095035,21095035,30485656,72675726,360328545,382010080,-21681535,-5.6756447369,382010080
EC105,219542765,0,294544000,294544000,42462624,22120608,20599758,85182990,20833013,37957678,17177570,75968261,22252896,17009154,37526554,76788604,17805015,1520274,23545394,42870683,280810538,300247897,-19437359,-6.4737702393,294544000
EC106,ss,0,109008188,134164155,12655574,9434987,6674642,28765203,6032884,7161956,8319059,21513899,7007443,7499123,7949018,22455584,7776786,8099781,13787649,29664216,102398902,109007681,-6608779,-6.0626727762,134164155
EC107,43586876,0,52444507,54462355,14375299,3161066,2066389,19602754,2195244,2178931,8637777,13011952,2161239,2109278,6469600,10740117,6057469,2842972,2217222,11117663,54472486,52444180,2028306,3.8675521288,54462355
EC108,538366101,0,619063916,621907163,95034608,59233608,25257533,179525749,36892259,38251153,60876252,136019664,38830559,38212236,56434717,133477512,34337654,37071062,43918171,115326887,564349812,619063923,-54714111,-8.8382005423,621907163
EC109,107555658,0,108593060,117679791,31891545,8245568,6387571,46524684,8341514,19432368,5214872,32988754,4233007,4500543,15779754,24513304,8363583,3901334,9555209,21820126,125846868,108593071,17253797,15.8884879497,117679791
EC121,176137262,0,245989468,245989468,5000,69343717,313008,69661725,3943801,1035355,3943801,8922957,0,60223303,33150,60256453,371142,1034446,6365068,7770656,146611791,193823532,-47211741,-24.3581058052,245989468
EC122,200209131,0,214494060,229142684,0,97111571,0,97111571,2554508,1248465,2369493,6172466,4474460,1591258,53981548,60047266,3504693,1103595,1740938,6349226,169680529,214494429,-44813900,-20.8928037007,229142684
EC123,68091690,0,78851003,82020648,15040156,3125118,5260439,23425713,3065959,15120663,3200556,21387178,2336129,2961891,13348796,18646816,5201840,3116244,3983382,12301466,75761173,78851000,-3089827,-3.9185641273,82020648
EC124,162755212,0,214090491,215844704,47416402,6065185,5515337,58996924,7137125,4027755,42648071,53812951,4086073,6017507,33927135,44030715,4129552,3040529,10883100,18053181,174893771,214090488,-39196717,-18.3084813184,215844704
EC126,87061082,0,118937976,101362881,38681518,853687,795228,40330433,784856,5585499,18957670,25328025,1371512,997539,21737388,24106439,1055555,982536,1049835,3087926,92852823,118937981,-26085158,-21.9317309582,101362881
EC127,185983988,0,216636182,206545924,49137059,0,12316041,61453100,6273632,35077235,4322459,45673326,4572480,9450356,41258369,55281205,5124396,2907247,5780050,13811693,176219324,216636180,-40416856,-18.6565586598,206545924
EC128,64853251,0,62622858,67124477,12340811,3467252,2086598,17894661,2474057,1822461,2384472,6680990,1388833,4137513,2202804,7729150,933851,6770898,1971362,9676111,41980912,62622724,-20641812,-32.9621752002,67124477
EC131,215828717,0,211233157,211233157,57301563,12577655,10218975,80098193,13359654,6692081,16329940,36381675,622034,758723,19754391,21135148,20273847,0,0,20273847,157888863,226053180,-68164317,-30.1541066576,211233157
EC132,66070490,0,96824276,96824276,17983818,-59931,1141742,19065629,1144512,11276244,6448959,18869715,1766169,910614,9896949,12573732,2522050,934980,0,3457030,53966106,96824281,-42858175,-44.2638711668,96824276
EC133,65980942,0,61222258,61222258,2650658,2732740,2542139,7925537,2100744,2099854,2210790,6411388,0,0,13763709,13763709,0,0,0,0,28100634,57865246,-29764612,-51.4378043083,61222258
EC134,538211997,0,456212643,480931578,117396424,15312283,65561432,198270139,25999701,63411297,18938594,108349592,12054036,31198340,56531474,99783850,20310026,-6616965,32965969,46659030,453062611,456212793,-3150182,-0.6905071599,480931578
EC135,207868818,0,147572000,147572000,47075919,2283080,2939427,52298426,1375652,37912540,1458048,40746240,1458048,2484074,0,3942122,0,702845,5706964,6409809,103396597,140573065,-37176468,-26.4463665212,147572000
EC136,162305356,0,168489051,172567455,40935815,1626925,5954334,48517074,1791365,38146585,10413288,50351238,-498630,3572412,33593022,36666804,2697030,3512793,4540322,10750145,146285261,168489075,-22203814,-13.1781921172,172567455
EC137,127060583,0,153899148,153899148,43480826,3781496,1699702,48962024,1706436,37520406,1817797,41044639,2573866,5053752,28892096,36519714,3265128,1736020,1720169,6721317,133247694,153899148,-20651454,-13.4188228255,153899148
EC138,98965966,0,130473,130473,65068444,2004729,2543060,69616233,0,22162404,1679700,23842104,2871231,2805700,16876609,22553540,2393609,1842492,1470463,5706564,121718441,108958056,12760385,11.7112818166,130473
EC141,138737312,0,199025199,194385320,59051547,57675064,3932096,120658707,3788108,37003123,4557639,45348870,3401006,4350134,29756332,37507472,2091084,2665370,7024085,11780539,215295588,199024860,16270728,8.1752239394,194385320
EC142,158360741,0,158751472,165405879,55230781,6173961,4410959,65815701,3715897,41995942,7582898,53294737,3790470,3914519,35679294,43384283,4683035,5007386,5707069,15397490,177892211,158751466,19140745,12.0570508621,165405879
EC143,115201229,0,130034620,124822530,28964950,5828198,6837957,41631105,6203049,13256797,7227087,26686933,5779667,6156318,2664792,14600777,5963959,6406016,13543766,25913741,108832556,130034620,-21202064,-16.3049378696,124822530
EC144,63327053,0,103149735,103149735,10581714,14053955,5164828,29800497,5137952,10062440,9703089,24903481,7978986,2377707,9179274,19535967,12970932,5404813,5665071,24040816,98280761,103149701,-4868940,-4.7202657427,103149735
EC153,223804009,0,221194268,194541940,68131698,2581307,1093149,71806154,2004552,51607409,2815651,56427612,1934207,1170923,12130749,15235879,1180843,4207392,2981798,8370033,151839678,221194268,-69354590,-31.3546054457,194541940
EC154,99237120,0,108758164,108758164,36178810,35905701,265441,72349952,1346830,25846868,1570779,28764477,598580,615185,0,1213765,263332,932460,0,1195792,103523986,110478265,-6954279,-6.2947033066,108758164
EC155,172662586,0,210547175,223587431,69855068,3813859,1652979,75321906,2700837,59301111,1925281,63927229,1006506,4902567,46809933,52719006,675245,720095,3316828,4712168,196680309,210547175,-13866866,-6.5861087901,223587431
EC156,140335897,0,162163508,162163508,54916587,1834686,625466,57376739,1586055,44682870,1850103,48119028,710662,1748657,35525280,37984599,1163174,322161,0,1485335,144965701,162163511,-17197810,-10.6052279541,162163508
EC157,689426589,0,814452372,798821954,92537233,27372185,73144230,193053648,39802655,95132754,28042151,162977560,27563395,22227301,326756544,376547240,11029737,3836893,-26001919,-11135289,721443159,814451085,-93007926,-11.4197068078,798821954
EC441,234034968,0,310950418,307883017,58976905,26881091,6655954,92513950,13263306,51784816,7055368,72103490,8717433,8079253,46949436,63746122,6577451,5685311,1598600,13861362,242224924,310950420,-68725496,-22.1017537137,307883017
EC442,186114837,0,205395400,210400651,32412849,24019582,1360310,57792741,1509141,1020120,1227465,3756726,1919959,1919959,4744299,8584217,1676097,1676097,30901445,34253639,104387323,205395139,-101007816,-49.17731573,210400651
EC443,171625070,0,307497178,337715508,62289586,4843426,3715172,70848184,3630768,52203956,4214022,60048746,4553467,4734124,42676701,51964292,7085213,4409281,5450002,16944496,199805718,307497197,-107691479,-35.0219384276,337715508
EC444,82595916,0,90614139,105390762,769242,1971082,351969,3092293,351969,26994969,741969,28088907,741969,740969,22602150,24085088,22602150,22602150,351969,45556269,100822557,90594132,10228425,11.2903835758,105390762
EKU,23548606845,0,26310700762,26607068433,2748100829,2607732874,2121583949,7477417652,1820111983,2583789976,2366773228,6770675187,1719079953,1793886915,2855213181,6368180049,1802681833,1761768516,1904373558,5468823907,26085096795,26310700756,-225603961,-0.8574608601,26607068433
ETH,24423514180,0,26725375219,26794956379,2653665305,2641771710,1841417126,7136854141,1948596265,2166532518,2887877269,7003006052,1846156707,1925868648,3517436867,7289462222,1966669212,1889047435,1753865365,5609582012,27038904427,26725375221,313529206,1.1731517459,26794956379
FS161,107427200,0,112525351,112524939,4038937,4049277,4042493,12130707,3629332,3909837,20165702,27704871,3762688,3711699,3345416,10819803,3889514,3440606,4349377,11679497,62334878,112525349,-50190471,-44.6037016957,112524939
FS162,0,0,217961608,209450000,38181137,6500049,4549501,49230687,6000620,6109896,32815765,44926281,6573592,6814008,27864313,41251913,6145712,6065712,6065712,18277136,153686017,209150700,-55464683,-26.5190042395,209450000
FS163,135326569,0,132331987,132727625,20007580,4088429,2717247,26813256,2427571,1949964,19194906,23572441,1994311,2540271,16498235,21032817,1825938,1749137,1713369,5288444,76706958,132331988,-55625030,-42.0344550405,132727625
FS164,81365059,0,89547898,81365059,8654602,4875534,4909208,18439344,4852383,4201843,4002052,13056278,4134549,4075956,4359502,12570007,3517950,3489288,3711521,10718759,54784388,89180141,-34395753,-38.5688479681,81365059
FS181,172964103,0,192682926,192108000,56299561,11371025,11053494,78724080,9750393,21281096,7893965,38925454,10373076,9606620,9704198,29683894,6276659,7136320,26711025,40124004,187457432,181446209,6011223,3.3129504513,192108000
FS182,68951804,0,72583041,72583040,19725474,3747134,12019006,35491614,2257088,2233641,16759112,21249841,2268489,-3311108,14103246,13060627,1997809,2052200,2277369,6327378,76129460,72583041,3546419,4.8860160048,72583040
FS183,145924150,0,112142419,122374695,15015230,26727869,3805984,45549083,3950611,3479144,3862284,11292039,3471911,26078036,20202957,49752904,3656809,3686133,3779090,11122032,117716058,112142895,5573163,4.9696978128,122374695
FS184,1645024257,0,1797825637,1787825949,291130992,104837383,147106890,543075265,135211437,226428489,124452423,486092349,128429109,123937292,132659208,385025609,126951170,176327401,235737877,539016448,1953209671,1797825358,155384313,8.6429036229,1787825949
FS185,327704697,0,360759875,338141000,68977883,19942824,17530027,106450734,850409,17397907,53468756,71717072,18389667,14919606,18184589,51493862,19538291,30540030,38209277,88287598,317949266,360759874,-42810608,-11.8667876018,338141000
FS191,355152031,0,392718780,391002097,81292065,19558717,22285265,123136047,18371188,18370229,72414745,109156162,17087013,15203381,59620904,91911298,63457946,18517929,17353726,99329601,423533108,392718767,30814341,7.8464141745,391002097
FS192,566443757,0,602996363,602996363,103694771,40285746,36070635,180051152,65938063,35782786,76436897,178157746,39000472,37143242,37025712,113169426,37189883,34715802,69967821,141873506,613251830,602996363,10255467,1.7007510541,602996363
FS193,216406989,0,243341218,285583000,45718061,17687725,14761207,78166993,14534878,15302443,13344304,43181625,15815610,14367901,13888004,44071515,23322613,25800331,55498126,104621070,270041203,243341363,26699840,10.9721749196,285583000
FS194,927087660,0,1400829715,1411446211,220611115,-18045875,57006166,259571406,35278288,203959555,66527990,305765833,40470039,47576525,47585814,135632378,42241977,59114542,48635288,149991807,850961424,1255708465,-404747041,-32.2325645069,1411446211
FS195,102589591,0,109885728,111679378,29016044,9273550,64140,38353734,4006652,5730713,22578063,32315428,5921350,8562769,19749579,34233698,4423578,3875902,0,8299480,113202340,109885716,3316624,3.0182485229,111679378
FS196,196163638,0,218108260,218108260,22523338,10220341,26471811,59215490,3177028,9359026,40032865,52568919,8562292,10203674,10813172,29579138,10592821,16661001,12583829,39837651,181201198,214951731,-33750533,-15.7014474101,218108260
FS201,0,0,447570182,447570182,104732863,36886191,36868328,178487382,35773062,34058722,38120209,107951993,34387172,34516454,36659236,105562862,34469013,53160422,33002608,120632043,512634280,618591964,-105957684,-17.1288490906,447570182
FS203,539021483,0,483684932,484547000,78945572,30467103,34709707,144122382,10201339,50560396,6297454,67059189,94804024,14885047,51481696,161170767,29178567,21628214,24158413,74965194,447317532,483684936,-36367404,-7.518820888,484547000
FS204,682115826,0,828986180,829294880,58610309,92206901,63763337,214580547,53394882,51756222,84964116,190115220,50797069,48456571,46973165,146226805,82098523,56805017,67325313,206228853,757151425,828985640,-71834215,-8.6653147574,829294880
FS205,160138041,0,154253106,162620967,7915569,8469245,6869518,23254332,8225775,8058468,7378581,23662824,7825656,7687317,7619253,23132226,7292647,7116042,6915310,21323999,91373381,154412114,-63038733,-40.8249918786,162620967
GT421,4735853249,0,4708535688,4808496278,575600445,354085760,358510690,1288196895,342040541,534459559,309664069,1186164169,407694646,314132111,491728612,1213555369,780296020,98302696,250693714,1129292430,4817208863,4708535695,108673168,2.3080034864,4808496278
GT422,688041369,0,739384683,774431692,79949711,54529401,58864227,193343339,54467115,75172161,54216582,183855858,50836775,52449359,70304646,173590780,52930267,57190001,0,110120268,660910245,733835670,-72925425,-9.9375688565,774431692
GT423,476286311,0,546168132,546168132,39949886,45006181,44325607,129281674,45983004,46298139,35393390,127674533,42343146,52387836,43766127,138497109,40068588,44548012,53515863,138132463,533585779,546168131,-12582352,-2.3037506742,546168132
GT481,2006543674,0,2001307949,2036247569,230567406,147530088,192772501,570869995,119171333,143664593,145486470,408322396,143755104,153665970,277886981,575308055,133766233,133475495,164215346,431457074,1985957520,2001307980,-15350460,-0.7670213757,2036247569
GT482,757273175,0,939819056,908386976,103441583,61661342,61030323,226133248,59987365,64599565,84418641,209005571,54398281,87664283,54780978,196843542,35276639,79375603,82501229,197153471,829135832,939818985,-110683153,-11.7770714113,908386976
GT483,424990694,0,474256880,622833502,81192405,61145516,45852100,188190021,37741365,0,73322930,111064295,36423631,0,62025718,98449349,62025718,74643538,54690698,191359954,589063619,474257196,114806423,24.2076291026,622833502
GT484,1388547870,0,1170174982,1301472277,137475613,86943930,92029578,316449121,81236835,61883724,10358339,153478898,66574659,80919366,126175668,273669693,62960915,59475290,55496115,177932320,921530032,1170174480,-248644448,-21.2484934725,1301472277
JHB,35812493000,0,39307283000,40793454280,3033026169,2959718536,3391769423,9384514128,3234112625,3058018697,3825250901,10117382223,2860469789,3190723493,4396582516,10447775798,2913218000,2836151242,3971067913,9720437155,39670109304,38844218004,825891300,2.1261627661,40793454280
KZN211,65786582,0,63680667,75493814,19580786,507856,1133355,21221997,474998,17884538,1408636,19768172,1078867,1568505,13876327,16523699,505926,2790331,5213961,8510218,66024086,63680667,2343419,3.6799536035,75493814
KZN212,136002890,0,150943490,147796104,94082198,854190,1293240,96229628,1295576,15529628,810772,17635976,1707265,865254,13195264,15767783,1582431,687487,872519,3142437,132775824,150943494,-18167670,-12.0360735786,147796104
KZN213,95404172,0,127476942,122816752,13402157,6619765,8808396,28830318,8735159,8113994,9634954,26484107,9149628,9430683,7337508,25917819,13582328,8333601,17847105,39763034,120995278,127476942,-6481664,-5.0845775701,122816752
KZN214,3774325,0,117490423,123688677,15225070,9592757,28322242,53140069,4386245,24273032,3921854,32581131,3211534,5751254,6984623,15947411,25695556,789703,4575457,31060716,132729327,117490281,15239046,12.9704737024,123688677
KZN215,38359054,0,44269000,44311529,438526,811437,612193,1862156,607157,11213943,1371435,13192535,1094425,997863,9965908,12058196,1119285,625333,0,1744618,28857505,44269200,-15411695,-34.8135837106,44311529
KZN216,624087671,0,705028961,705028961,86551258,72600344,72600344,231751946,72600344,72600344,39108863,184309551,47680678,42346761,71532853,161560292,43507508,10149407,84949337,138606252,716228041,705028561,11199480,1.5885143694,705028961
KZN221,104816646,0,109279000,120359000,32590304,5667580,4339547,42597431,3775838,27292056,3922046,34989940,4138212,4281611,23116325,31536148,3795489,4161021,4170919,12127429,121250948,109279000,11971948,10.9553967368,120359000
KZN222,257402763,0,264126474,286011660,35133240,17708951,17832685,70674876,15690124,28427401,17021898,61139423,15281776,19816286,26777749,61875811,15920510,16040497,43368133,75329140,269019250,264126207,4893043,1.8525397595,286011660
KZN223,91908378,0,110551366,107990600,0,9013267,3633942,12647209,3633942,12138977,6624886,22397805,5117478,5117478,12912851,23147807,0,12912851,12912851,25825702,84018523,110570012,-26551489,-24.0132821908,107990600
KZN224,28896798,0,40967556,47034326,13979846,9162974,964954,24107774,1116827,10397404,418057,11932288,993164,747525,9162975,10903664,39967,259391,0,299358,47243084,40967411,6275673,15.3186956335,47034326
KZN225,3484538419,0,3570334170,3695132643,237665754,517041788,213498477,968206019,286515648,278456644,390262059,955234351,233504573,290617251,279390268,803512092,367771220,276829390,409896776,1054497386,3781449848,3570574974,210874874,5.905908027,3695132643
KZN226,60798145,0,70017703,68176701,17032261,1522714,1666885,20221860,1701418,16396862,2014458,20112738,1921377,2270429,12436136,16627942,2056979,2082193,4858779,8997951,65960491,70017719,-4057228,-5.794573228,68176701
KZN227,81804354,0,62453780,68119786,17011732,12654834,-3080545,26586021,1168279,16130809,1006298,18305386,1411438,1619667,12471584,15502689,1739041,1701713,2194435,5635189,66029285,62454028,3575257,5.7246219571,68119786
KZN232,525366664,0,613922108,586599654,103856620,50280024,37495537,191632181,35200545,33043842,69953267,138197654,33009597,36881468,65570398,135461463,33210435,32402360,26461337,92074132,557365430,613922108,-56556678,-9.2123540207,586599654
KZN233,73354668,0,77723992,80120788,29598601,1115091,848897,31562589,961993,1533049,1533049,4028091,12790514,1185341,29397494,43373349,927051,760499,981760,2669310,81633339,77723982,3909357,5.0297950509,80120788
KZN234,294154489,0,316420829,302454134,35446240,23063001,27377809,85887050,21349985,18168593,29818383,69336961,21462697,23283629,31405806,76152132,20876519,22927467,25418980,69222966,300599109,316420829,-15821720,-5.0002144454,302454134
KZN235,112954413,0,133714160,126464523,39397419,8574164,4804131,52775714,3247840,27977390,2778606,34003836,2476410,7627395,24140901,34244706,2892329,2644548,2644548,8181425,129205681,133714160,-4508479,-3.3717289179,126464523
KZN236,85841639,0,88825860,90608535,34761982,2719226,636942,38118150,682036,22376346,680465,23738847,1486013,1264176,20632182,23382371,807439,1137704,688326,2633469,87872837,88825877,-953040,-1.0729305831,90608535
KZN242,161060990,0,136252765,138206836,19804271,2264869,2288229,24357369,2669153,32984050,0,35653203,2053494,2460804,28162298,32676596,28162298,2147112,-3285793,27023617,119710785,136252516,-16541731,-12.1404958129,138206836
KZN244,80091422,80091422,125395941,129249500,1353733,1596457,42644184,45594374,4734487,1333599,1314732,7382818,1036032,1036032,1036032,3108096,1036032,1036032,1036032,3108096,59193384,125395941,-66202557,-52.7948165404,129249500
KZN245,176155740,0,164556302,172210970,40348501,12117431,16542496,69008428,12017917,10966846,43954087,66938850,15886457,16635752,15969371,48491580,26102320,0,23695160,49797480,234236338,164556302,69680036,42.3441917162,172210970
KZN252,1456210889,0,1526361893,1508569891,74036197,227789227,108766077,410591501,88212676,195309478,120113611,403635765,108696131,93435563,173663968,375795662,180983968,108425322,20084799,309494089,1499517017,1526361893,-26844876,-1.7587490963,1508569891
KZN253,67588221,0,63249252,54590337,17921807,3377028,3276795,24575630,3723950,7809173,4067246,15600369,5527668,3070785,8304868,16903321,3653907,3567785,0,7221692,64301012,63249246,1051766,1.6628909695,54590337
KZN254,81660240,0,91164046,94584220,1439046,2224447,2027508,5691001,2655461,23707222,1861952,28224635,2388971,1546964,17825945,21761880,1422952,1504443,3322005,6249400,61926916,90387645,-28460729,-31.4874106965,94584220
KZN261,69774654,0,92441285,94403399,21753456,2202837,4540799,28497092,4195754,13498144,10923583,28617481,2891705,4924452,20738945,28555102,2550646,602032,2412157,5564835,91234510,92441292,-1206782,-1.3054577385,94403399
KZN262,130704449,0,150583861,124671742,33921653,3888294,6180051,43989998,6412416,31998542,7645124,46056082,7660679,15403720,21452978,44517377,7164264,6651776,6294607,20110647,154674104,150583861,4090243,2.7162558941,124671742
KZN263,456312392,0,420009910,433555700,62010378,24543542,34641466,121195386,24572431,26928817,55846901,107348149,27111848,36251206,49778168,113141222,22408947,29644019,19565446,71618412,413303169,420009442,-6706273,-1.5966957714,433555700
KZN265,103669523,0,133252000,123289862,46256535,5398272,1684299,53339106,1584185,26110726,1563348,29258259,1491506,1639580,27742212,30873298,1526328,1614539,1171388,4312255,117782918,133251989,-15469071,-11.608885628,123289862
KZN266,210580676,0,246426594,259951620,73439681,9649592,10179438,93268711,8548094,38249718,7161667,53959479,7751247,5345888,31639907,44737042,7652529,7868937,28971692,44493158,236458390,246425800,-9967410,-4.0447915762,259951620
KZN271,97477222,0,116739436,139679800,39274604,4502745,4432975,48210324,4485465,33539967,4429394,42454826,4089149,2779137,26957327,33825613,3396947,2952756,3518410,9868113,134358876,116739573,17619303,15.0928280336,139679800
KZN272,122223224,0,163116842,149356574,54592174,2480427,2609956,59682557,3051728,37804179,3250632,44106539,1864980,1775882,30059763,33700625,1982313,1883972,1833427,5699712,143189433,163116950,-19927517,-12.2167052535,149356574
KZN273,42460958,0,52186000,58335743,11138536,1273516,1355111,13767163,6190146,11150642,3950712,21291500,2108016,1833783,2216306,6158105,1201121,2245805,1793188,5240114,46456882,52185367,-5728485,-10.9771863825,58335743
KZN274,51597570,0,56116468,55816152,14756377,177744,678795,15612916,279168,12403429,6705610,19388207,224294,205440,10338775,10768509,4931396,368096,1626980,6926472,52696104,56115736,-3419632,-6.0938913819,55816152
KZN275,103120982,0,135955608,127347095,39015175,6996545,3842545,49854265,3213324,30269095,3507187,36989606,3564093,5257540,21656874,30478507,3782193,4756930,3701565,12240688,129563066,135955608,-6392542,-4.7019332958,127347095
KZN282,2307446988,0,2370558500,2288540300,188321558,233161760,208205014,629688332,176391069,208643255,180225417,565259741,216909251,201633568,200509901,619052720,202068492,167945351,216113994,586127837,2400128630,2370558500,29570130,1.2473908575,2288540300
KZN283,48954968,0,45934152,53969641,12545940,929337,451146,13926423,666249,666249,1188420,2520918,722242,967109,9254815,10944166,1490592,2062600,2062600,5615792,33007299,45933813,-12926514,-28.1416088841,53969641
KZN284,253738865,0,234105520,261959930,68027659,6561898,17078998,91668555,8606044,46927310,11136470,66669824,9072246,8952528,24390511,42415285,7030165,31226125,6491793,44748083,245501747,234105540,11396207,4.8679783486,261959930
KZN285,72357590,0,78605158,93961000,17047886,3533834,3960711,24542431,3872716,14010830,4965003,22848549,4321922,4395064,14761383,23478369,3934198,6555824,4320987,14811009,85680358,78605163,7075195,9.000929112,93961000
KZN286,78022667,0,104884376,104774633,29255631,3956183,1713582,34925396,9466146,1274439,1478401,12218986,1411159,2004777,19405857,22821793,809132,1437121,2337156,4583409,74549584,104884522,-30334938,-28.922225531,104774633
KZN291,174758086,0,152397887,171870887,39218242,10675861,6297432,56191535,11881006,36016977,10176951,58074934,6895032,9825052,30045358,46765442,18921898,12232070,0,31153968,192185879,152397878,39788001,26.1079757292,171870887
KZN292,1051410287,0,1139563134,1175746983,89246066,92254764,85366731,266867561,86356084,101855566,100845355,289057005,87503384,86233648,129295188,303032220,94343149,82576993,98932466,275852608,1134809394,1139563133,-4753739,-0.4171545097,1175746983
KZN293,81723776,0,96381231,98923790,36704036,953467,356897,38014400,1302937,28288651,1551316,31142904,1147003,1954196,24205411,27306610,2378081,824550,402150,3604781,100068695,96381126,3687569,3.8260281375,98923790
KZN431,73777269,0,81640050,82698000,31615365,821284,1078611,33515260,999088,22627510,1067812,24694410,1421017,967592,18809262,21197871,1056396,1195195,8917068,11168659,90576200,81640050,8936150,10.9457919244,82698000
KZN433,247663689,0,259000642,268896730,66087410,33945575,13500395,113533380,14550039,11919051,28230919,54700009,12828890,12340805,25587514,50757209,13500295,12355754,13080912,38936961,257927559,259000101,-1072542,-0.4141087188,268896730
KZN434,94695978,0,105035029,117786233,13300703,1773271,204702,15278676,1810984,23838961,828722,26478667,2075569,0,22700069,24775638,4116377,2455770,1609696,8181843,74714824,105034984,-30320160,-28.8667250142,117786233
KZN435,119441915,0,138049461,141747185,54459779,6668085,2190569,63318433,1279842,40861696,988491,43130029,2038007,1669812,34184270,37892089,977810,1340271,1138774,3456855,147797406,138049462,9747944,7.0611966601,141747185
LIM331,201587989,0,240309947,245709000,76113322,5798575,4663848,86575745,5107935,60748908,5846476,71703319,0,5477546,52363660,57841206,3930304,4048893,4964693,12943890,229064160,240309947,-11245787,-4.679701003,245709000
LIM332,189190875,0,276686219,233318732,3707774,3758617,3839865,11306256,3828374,5348907,5278598,14455879,3661549,4186466,3419616,11267631,3065620,3319914,3731414,10116948,47146714,231805221,-184658507,-79.661064666,233318732
LIM333,743449001,0,824367771,856276867,148104561,54041309,52033937,254179807,148018751,52730873,114970019,315719643,46957322,46553928,15459421,108970671,44284211,44120369,51583120,139987700,818857821,824367768,-5509947,-0.6683845747,856276867
LIM334,298399518,0,356251313,356251314,51200345,25137671,22113970,98451986,19616128,41297207,28544904,89458239,19313432,24996419,20656653,64966504,26797921,37873584,28943108,93614613,346491342,356251332,-9759990,-2.7396360724,356251314
LIM335,91143626,0,102166815,102166815,30347078,3547152,3961485,37855715,3978902,27207316,15383437,46569655,4078771,3245771,31230515,38555057,4214628,4550841,0,8765469,131745896,102166817,29579079,28.951747611,102166815
LIM341,149564278,0,187228000,209235497,29917262,25472865,25465039,80855166,25593177,33491482,35389124,94473783,12151625,11983499,28321984,52457108,11179260,16645464,15615057,43439781,271225838,187228095,83997743,44.8638560361,209235497
LIM342,59147962,0,82095598,107779548,27320994,1270751,1170389,29762134,1337823,23062904,1651675,26052402,-1185348,793702,18971108,18579462,823580,659108,2149862,3632550,78026548,82095595,-4069047,-4.9564742176,107779548
LIM343,453106619,0,742180422,625685612,148024233,15666531,15939703,179630467,14163060,126761159,14776383,155700602,13856957,14450836,106429297,134737090,19702550,43290510,105461978,168455038,638523197,742180424,-103657227,-13.9665805845,625685612
LIM344,569454250,0,656222000,646827000,144933841,16743837,28063655,189741333,27006882,127489104,27675244,182171230,25786087,28165767,27258000,81209854,106779756,29254207,29624655,165658618,618781035,656222944,-37441909,-5.7056689868,646827000
LIM351,138536643,0,164957910,165981910,13517751,52484774,1581911,67584436,2900120,40855230,2426482,46181832,2633633,2444973,33660860,38739466,2200054,2291550,3327489,7819093,160324827,164957911,-4633084,-2.80864614,165981910
LIM352,144401524,0,102409621,100312307,41234294,1992146,481336,43707776,726480,28416583,561271,29704334,612260,2060073,12259168,14931501,779959,4676074,1034409,6490442,94834053,102409620,-7575567,-7.3973197049,100312307
LIM353,109554429,0,125435694,136452963,37620258,3495392,1632276,42747926,2676604,2946234,33036030,38658868,2252727,2280691,27029498,31562916,2502840,3259939,4373752,10136531,123106241,125435696,-2329455,-1.8570909831,136452963
LIM354,1932949289,0,2228099004,2200327000,310397383,120087280,115219525,545704188,125633707,124153648,278602709,528390064,113760124,101665378,229675096,445100598,122792430,113377169,197866160,434035759,1953230609,2228099053,-274868444,-12.3364553129,2200327000
LIM355,215383427,0,288474158,282027322,72942189,7096741,7945844,87984774,8631708,58708598,7223998,74564304,9164797,7698442,51812946,68676185,8477508,8590684,11428010,28496202,259721465,288474157,-28752692,-9.9671638871,282027322
LIM361,203921626,0,267389068,347886135,39551885,16292297,12234935,68079117,19858199,14609668,27285393,61753260,4791594,8913102,12306874,26011570,14715178,16835143,22324210,53874531,209718478,267388586,-57670108,-21.5679019298,347886135
LIM362,326325171,0,352071025,352071025,56299380,0,0,56299380,0,0,0,0,0,0,0,0,0,0,0,0,56299380,352072106,-295772726,-84.009133629,352071025
LIM364,113002795,0,124683400,126929300,0,8167448,7486110,15653558,8063858,14618802,5508582,28191242,6449003,7711393,38448792,52609188,0,0,10364843,10364843,106818831,124683412,-17864581,-14.3279532645,126929300
LIM365,235897208,0,253234971,256602996,38629241,13789527,16696084,69114852,17140507,14789339,35798005,67727851,14607252,15924845,31065598,61597695,16021064,15638857,20869656,52529577,250969975,253234964,-2264989,-0.8944219093,256602996
LIM366,283647767,0,307178964,307242304,44063435,20478875,18247505,82789815,16753089,36468814,16660750,69882653,19017968,15505656,0,34523624,0,0,0,0,187196092,307178970,-119982878,-39.0596003366,307242304
LIM367,0,0,683202735,683202735,145851286,34216731,32616089,212684106,34034044,11538167,103500277,149072488,122672554,24812362,109306864,256791780,36968112,39176306,33296985,109441403,727989777,683202735,44787042,6.5554541435,683202735
LIM471,0,0,223494460,223494460,44371827,9179997,9492437,63044261,6385491,7064617,36943345,50393453,7276168,8667353,31229275,47172796,7191147,7562654,8591442,23345243,183955753,223494460,-39538707,-17.6911351628,223494460
LIM472,245094723,0,280117600,285222900,73668491,9658875,8295837,91623203,11622391,63452379,7140917,82215687,11446726,8829856,52278634,72555216,9547583,7574490,5134210,22256283,268650389,280117607,-11467218,-4.0937155371,285222900
LIM473,232910241,0,252279393,249466877,77265690,12032066,4959508,94257264,5132689,5093161,54743281,64969131,5175650,5806148,54276865,65258663,4868534,4868534,6702313,16439381,240924439,252279394,-11354955,-4.5009442983,249466877
LIM474,74724762,0,89991899,90845953,28341530,3968332,2493796,34803658,2193457,3719267,23144337,29057061,2842582,2370138,17411726,22624446,17411726,2034925,966711,20413362,106898527,89991899,16906628,18.786833246,90845953
LIM475,0,0,0,402967500,99103306,7886950,6880595,113870851,38055540,11053904,37430558,86540002,0,7574151,118124714,125698865,7610474,28733036,6861496,43205006,369314724,401650500,-32335776,-8.0507246972,402967500
MAN,4958020941,0,6312594088,5729939295,660889374,531028416,390566639,1582484429,379490798,394787794,662928917,1437207509,387109307,392774437,589097316,1368981060,412296173,302595790,293599982,1008491945,5397164943,6293327076,-896162133,-14.2398785599,5729939295
MP301,281183276,0,296473720,299590297,0,81166937,8635159,89802096,-8373278,0,16720560,8347282,5539400,4341656,5598492,15479548,6749533,6341130,18080860,31171523,144800449,296473717,-151673268,-51.1590941466,299590297
MP302,466211138,0,470547905,480906443,33891008,30961235,76900476,141752719,28784912,47481517,35028656,111295085,33330558,26481037,29315685,89127280,26911885,37824529,27152318,91888732,434063816,470548014,-36484198,-7.7535547733,480906443
MP303,270322675,0,342611022,330924535,67332820,11965490,9073802,88372112,19461139,62594418,15486246,97541803,15108933,19669442,16765862,51544237,16367609,16491679,16491679,49350967,286809119,342610928,-55801809,-16.2872239148,330924535
MP304,219860459,0,235686945,223425113,0,16932844,10733771,27666615,9703054,55604494,9841525,75149073,18048172,41194400,31289726,90532298,13061129,26317118,15782205,55160452,248508438,235686936,12821502,5.4400562957,223425113
MP305,0,0,490215790,490215790,68908671,27630889,34851742,131391302,28529144,0,40602173,69131317,38412803,34943393,33081377,106437573,32679237,32584686,67807023,133070946,440031138,490215792,-50184654,-10.2372577177,490215790
MP306,164400195,0,149065436,156852356,26791794,10333371,7820924,44946089,8999844,24240300,8054724,41294868,9020459,9267393,20720154,39008006,8152593,20720154,11435913,40308660,165557623,149065839,16491784,11.0634227873,156852356
MP307,1378889465,0,1592997743,1546476804,180703294,116923841,94663342,392290477,98304988,98304983,158100447,354710418,114378249,109212636,107140900,330731785,93774859,85893977,156531168,336200004,1413932684,1592997752,-179065068,-11.2407608721,1546476804
MP311,0,0,0,0,55804909,14925522,35966370,106696801,21265333,29101723,52181110,102548166,16437617,0,26210650,42648267,21580062,27211344,27211344,76002750,327895984,316850853,11045131,3.4859085577,0
MP312,1660797569,0,1921544589,1887658995,211493661,171466882,103495544,486456087,136090505,139305329,180960393,456356227,133133326,126749478,130200487,390083291,136609434,153047869,250700022,540357325,1873252930,1921542956,-48290026,-2.5130859474,1887658995
MP313,1203303581,0,1303203453,1214466178,128001351,98532487,97280941,323814779,93849299,92261771,124295781,310406851,85138724,89597862,119902837,294639423,87378287,90892928,100001724,278272939,1207133992,1303203453,-96069461,-7.3717930058,1214466178
MP314,176591193,0,191766378,185038816,44238794,8571974,8799035,61609803,12385488,8360734,25248878,45995100,9836533,13472104,11615388,34924025,9210057,11871258,23798928,44880243,187409171,191766367,-4357196,-2.2721377414,185038816
MP315,409720882,0,362939836,390230204,113593521,12934205,10629838,137157564,96157515,96157515,9704525,202019555,12889357,77046119,0,89935476,75347784,11156433,53561306,140065523,569178118,362940373,206237745,56.8241398154,390230204
MP316,529711827,0,367798264,359531000,121323000,13334003,8474000,143131003,17652000,77471870,7656000,102779870,10118678,8443154,0,18561832,19137333,9432842,19582000,48152175,312624880,367797671,-55172791,-15.0008538254,359531000
MP321,316277362,0,382358131,421669462,106041365,61244091,19405230,186690686,16692720,46949831,15668247,79310798,15433889,16429916,41767173,73630978,17500666,26796502,34515943,78813111,418445573,382358132,36087441,9.438125668,421669462
MP322,1537670614,0,1728151272,1746441219,282287651,97934136,114911718,495133505,113037161,107821692,237821316,458680169,135329048,137471308,120649916,393450272,221522548,109024556,104111390,434658494,1781922440,1728151270,53771170,3.1114851422,1746441219
MP323,197669989,0,220988382,220988382,39626208,8674082,12698864,60999154,12599488,32459133,12658827,57717448,12306411,10838703,10489728,33634842,14972416,10947477,31922593,57842486,210193930,220988208,-10794278,-4.884549315,220988382
MP324,487705121,0,577671316,573624856,158838203,21691702,18807258,199337163,14379072,14161860,136244646,164785578,21819400,19969504,36070408,77859312,23580319,33560711,116190435,173331465,615313518,577671329,37642189,6.5161947824,573624856
MP325,0,0,752799000,919068941,217467399,3639320,714884973,935991692,5844731,188249223,-488392759,-294298805,4676833,9675760,28924664,43277257,5198285,15714865,10374150,31287300,716257444,752799340,-36541896,-4.8541349678,919068941
NC061,48091443,0,58218406,61065365,16274954,1921167,1756159,19952280,2121963,6423552,6595389,15140904,16456474,5483759,4057541,25997774,2037542,426621,880832,3344995,64435953,58218325,6217628,10.6798469382,61065365
NC062,210513712,0,213551821,243285150,59449004,10510797,11842568,81802369,11121234,19186700,9853968,40161902,8035202,10017926,9410814,27463942,10766757,19156071,10889682,40812510,190240723,213551819,-23311096,-10.9158967173,243285150
NC064,33122289,0,36354250,38087000,6389956,2258345,1006789,9655090,7950782,1208951,1326568,10486301,6304893,1142168,1304006,8751067,1362922,3996660,1800072,7159654,36052112,36354484,-302372,-0.8317323387,38087000
NC065,68863700,0,80072726,80812012,9542168,4043689,3607618,17193475,3584215,3458780,3150831,10193826,18623534,3765294,3455122,25843950,4997775,1863986,3816008,10677769,63909020,80072725,-16163705,-20.1862806592,80812012
NC066,36928684,0,39468006,39468006,14515245,3018734,1744720,19278699,1622023,1768740,6444601,9835364,1836279,2686500,6685791,11208570,2138789,1774081,1863348,5776218,46098851,39469871,6628980,16.7950384231,39468006
NC067,46660715,0,48548740,52278810,6434797,3555632,4960279,14950708,2395612,1609841,4458868,8464321,2139897,6798009,2523971,11461877,2250483,4361679,3107222,9719384,44596290,48548760,-3952470,-8.1412377989,52278810
NC071,107210918,0,85475000,85475000,15883873,4975052,5857433,26716358,5083687,4056238,29489129,38629054,3433663,13486165,4826996,21746824,5270923,0,0,5270923,92363159,85474065,6889094,8.0598647087,85475000
NC072,95092980,0,101300870,109125310,21600689,5732495,5551150,32884334,4816337,14510040,4973047,24299424,5764404,7332495,12814308,25911207,5543460,5159598,13730608,24433666,107528631,101300867,6227764,6.147789436,109125310
NC073,185183222,0,200192897,189892897,20505786,26245870,11358998,58110654,10939222,21439302,9824550,42203074,10796965,10647702,19844216,41288883,9997387,12011813,13010224,35019424,176622035,200192907,-23570872,-11.7740794882,189892897
NC074,42704498,0,51979001,51979001,11918375,1847119,1903333,15668827,1693699,1620904,6623474,9938077,1975453,1551771,5798822,9326046,1826697,1506084,8132490,11465271,46398221,51979000,-5580779,-10.7366032436,51979001
NC075,59749033,0,42199000,42199000,9755905,2155927,1157870,13069702,1066045,0,0,1066045,403984,872865,1356032,2632881,1185328,616746,733937,2536011,19304639,42199000,-22894361,-54.2533259082,42199000
NC076,37111564,0,51289699,50985036,11884878,926335,1192083,14003296,1633418,1125530,11242868,14001816,1913719,1746360,2987665,6647744,2081597,3314603,4842036,10238236,44891092,51289699,-6398607,-12.4754231839,50985036
NC077,57169467,0,73989000,73989000,13992434,12295594,3200374,29488402,0,10439287,3150594,13589881,10439287,3388832,3660568,17488687,3162953,9050104,3547133,15760190,76327160,68660705,7666455,11.1657097025,73989000
NC078,106779041,0,134982706,118153004,22472780,6101944,6130438,34705162,1702370,12341823,3844029,17888222,3714486,3973126,4173456,11861068,3896951,3957823,18423851,26278625,90733077,134982600,-44249523,-32.7816496348,118153004
NC081,27803417,0,25207233,31727547,6749865,1621673,968222,9339760,1105994,4645058,686795,6437847,903991,732413,4257233,5893637,1060544,1031645,3744065,5836254,27507498,25207221,2300277,9.1254684521,31727547
NC082,151652698,0,186072171,170557105,51120060,8773599,6306510,66200169,8982570,24147294,8448441,41578305,11577869,15659094,9896493,37133456,9896493,8071676,8071676,26039845,170951775,186072192,-15120417,-8.1261024753,170557105
NC083,481899719,0,497170671,511548941,67624289,35215475,35689043,138528807,48512730,35257420,49663488,133433638,46111478,41778072,46731284,134620834,45977391,33495388,43117693,122590472,529173751,952910461,-423736710,-44.4676312563,511548941
NC084,28511875,0,36618000,34843475,9885677,915016,1810038,12610731,2642379,6097147,915458,9654984,1355524,1934444,0,3289968,1018667,968365,993232,2980264,28535947,31404756,-2868809,-9.1349507699,34843475
NC085,171404741,0,185391000,188391000,22259770,6902105,11453404,40615279,6902414,14719509,8134482,29756405,8417058,8312997,0,16730055,7956358,7956358,5239306,21152022,108253761,185391000,-77137239,-41.6078660776,188391000
NC086,69619131,0,74111001,74412000,11625916,3355979,9106497,24088392,3399251,7685117,0,11084368,3001963,0,0,3001963,2972040,2671960,3017531,8661531,46836254,74110725,-27274471,-36.8023265189,74412000
NC091,1521648781,0,1648409475,1675895579,297197903,121136288,100589512,518923703,125883663,84339812,170372936,380596411,130175256,105946028,152757178,388878462,117839763,92967792,116859321,327666876,1616065452,1648409853,-32344401,-1.9621577086,1675895579
NC092,125427560,0,110519550,116743550,26174145,5251062,5114126,36539333,6063797,20687620,13463140,40214557,4291185,9204628,1637997,15133810,5311831,19127458,8622405,33061694,124949394,110519550,14429844,13.0563723794,116743550
NC093,78341340,0,86315050,76630587,3530485,16545107,3755041,23830633,4467335,4126579,11162095,19756009,3740149,3402857,26576,7169582,26576,26576,26576,79728,50835952,86315049,-35479097,-41.104184509,76630587
NC094,180205172,0,201287486,202010000,37812864,8962996,8383715,55159575,8666798,8982910,34431779,52081487,8998078,9065326,9239159,27302563,0,28098969,28098969,56197938,190741563,201287363,-10545800,-5.2391763908,202010000
NC451,95241448,0,138163411,136513748,42885486,4149514,1234873,48269873,6643704,32924230,2405817,41973751,14353279,2448884,35287326,52089489,1194130,3654538,5987626,10836294,153169407,138163339,15006068,10.8611069395,136513748
NC452,266057763,0,303145558,298885662,64712895,10656070,15862880,91231845,10010382,37857402,10993674,58861458,11368276,10937827,36351497,58657600,10778559,9827707,16973970,37580236,246331139,303145562,-56814423,-18.7416311244,298885662
NC453,273626110,0,634708765,476576097,222852595,35023156,58945385,316821136,30720336,42420954,32181806,105323096,963408,51842566,126451753,179257727,54801396,38024691,0,92826087,694228046,634708774,59519272,9.3774144045,476576097
NMA,7473948478,0,8119587739,8291268226,891206675,371540071,565376441,1828123187,580239183,553968081,1078924675,2213131939,519100857,534484902,990015855,2043601614,607276186,522762895,604067843,1734106924,7818963664,8119587739,-300624075,-3.7024549111,8291268226
NW371,229846539,0,296428000,301659000,90926767,9889168,6495777,107311712,7186448,62827432,6777150,76791030,30688547,1568044,66707021,98963612,7434855,420104,17742225,25597184,308663538,296428033,12235505,4.1276477384,301659000
NW372,1109144691,0,1394012008,1394011893,61839513,76302497,79983834,218125844,223656856,86855379,168586742,479098977,71779392,94392921,75189931,241362244,84887507,156692024,76794107,318373638,1256960703,1394012020,-137051317,-9.8314300762,1394011893
NW373,2809462375,0,3599711979,3599711979,242089774,384407443,152417819,778915036,254161600,296960108,213184497,764306205,206801738,196954837,303338532,707095107,187435970,194862991,383788336,766087297,3016403645,3599711979,-583308334,-16.2043057168,3599711979
NW374,127440662,0,133424149,133424149,24541775,9576728,8643792,42762295,5844609,23246919,6547452,35638980,10863982,6703987,10226553,27794522,18149418,5611672,9557995,33319085,139514882,133424122,6090760,4.5649616491,133424149
NW375,0,0,502304985,517868000,120752142,14101212,13453866,148307220,14698712,82700231,39767699,137166642,15319240,10176824,86926920,112422984,13344941,14960564,42979208,71284713,469181559,502303800,-33122241,-6.5940653843,517868000
NW381,96256243,0,136110816,159473000,56456543,2010067,303226,58769836,329308,58702331,4060904,63092543,293340,13238744,29679721,43211805,2985281,1322395,363576,4671252,169745436,136110355,33635081,24.7116253572,159473000
NW382,140557972,0,153326733,153326733,36190432,6177017,4722634,47090083,0,10066013,0,10066013,11638232,5372541,4484515,21495288,9921985,18588001,0,28509986,107161370,153326731,-46165361,-30.1091405908,153326733
NW383,465505363,0,523829881,456252000,82114908,27419192,26989910,136524010,27555110,27449671,27323613,82328394,24483102,28700754,25125771,78309627,28658302,30248500,75797984,134704786,431866817,523830969,-91964152,-17.5560738945,456252000
NW384,296197543,0,345239153,335988000,18043405,99531765,17524921,135100091,17008791,14942348,11587389,43538528,14033858,15020069,15302810,44356737,14416840,14870232,18170851,47457923,270453279,345239154,-74785875,-21.662049085,335988000
NW385,281346123,0,218716811,249671099,46275906,8902243,8067799,63245948,7989204,8597837,7797828,24384869,8334215,7080276,73629901,89044392,7570023,8242063,15944795,31756881,208432090,218716811,-10284721,-4.7023001812,249671099
NW392,281662457,0,299472282,290694150,29865295,27889393,17860948,75615636,17405751,17405751,16166727,50978229,17344510,39018470,28072917,84435897,16490330,22778310,12394563,51663203,262692965,299472278,-36779313,-12.281374839,290694150
NW393,111008490,0,135753325,146459000,25383514,12851054,6901453,45136021,7085828,6611383,16692760,30389971,7106962,6952410,8232937,22292309,7358983,17330994,12382265,37072242,134890543,135752868,-862325,-0.6352167823,146459000
NW394,142534595,0,118192416,167009539,63922617,1706356,878581,66507554,1041416,46528182,1344675,48914273,1097596,1097596,48124843,50320035,48124843,1788648,1076960,50990451,216732313,169209829,47522484,28.0849429852,167009539
NW396,185830852,0,198906318,216810164,25802999,12088647,13460200,51351846,10895724,9492603,15588138,35976465,19130182,12153815,11309773,42593770,15058366,19423179,36508300,70989845,200911926,198906462,2005464,1.0082447698,216810164
NW397,0,0,105783001,105783001,48839985,16003268,224192,65067445,0,0,0,0,0,0,0,0,124922,403201,94018,622141,65689586,105783000,-40093414,-37.9015664143,105783001
NW401,122280416,0,137749749,137749749,28661265,6943068,5637095,41241428,0,19239538,10061456,29300994,5435274,5212086,7738228,18385588,6074114,5051906,10712020,21838040,110766050,137749749,-26983699,-19.5889278898,137749749
NW402,0,0,1068722183,1090014212,133445880,92077876,88358939,313882695,81834358,73537076,94190765,249562199,76876481,74241716,112832080,263950277,81524129,81871594,80022579,243418302,1070813473,1017141833,53671640,5.2767114928,1090014212
NW403,1701072557,0,2015105390,2118521000,239950964,131796635,126465128,498212727,132065522,192101295,128922911,453089728,123208526,133089935,132330951,388629412,131782386,276879622,145271304,553933312,1893865179,2015105081,-121239902,-6.016554826,2118521000
NW404,296819251,0,321299331,320858744,49207259,16650797,16635194,82493250,17718389,16318967,46807641,80844997,14606905,19417860,15188823,49213588,18404049,37973001,18607327,74984377,287536212,321299331,-33763119,-10.5083066606,320858744
TSH,21275352657,0,24939484039,25110961614,2417386267,2208631997,1819103533,6445121797,1777291320,2272418646,1936064055,5985774021,1472201500,1371891177,3422221699,6266314376,1705916201,1597115738,2221276642,5524308581,24221518775,24939484042,-717965267,-2.8788296734,25110961614
WC011,199854449,0,227768004,233320360,35103840,14560477,12641962,62306279,14496082,14487885,18901958,47885925,20203304,15471674,25509640,61184618,15733983,12347989,12922671,41004643,212381465,227768035,-15386570,-6.7553684607,233320360
WC012,170363975,0,187424600,224849142,29917873,12403559,11955377,54276809,20120386,22431938,14695771,57248095,20646626,11701048,22215931,54563605,14318733,17113160,13782268,45214161,211302670,187424600,23878070,12.7400938831,224849142
WC013,209544725,0,226318471,232019571,35098964,15784092,14898587,65781643,16083057,23274685,15366274,54724016,17637116,17603232,25835110,61075458,16428589,16890411,16846695,50165695,231746812,226318784,5428028,2.398399242,232019571
WC014,668584007,0,741754925,740127757,74874798,92224304,50878533,217977635,55035916,50794329,69653356,175483601,53431082,52970558,67305523,173707163,54760137,52419091,30841811,138021039,705189438,741754925,-36565487,-4.9295914011,740127757
WC015,455845062,0,436135731,480873594,56427562,32667514,28501799,117596875,32403626,44349048,31557038,108309712,37859897,29940863,44583326,112384086,30305411,29525585,44653891,104484887,442775560,436135740,6639820,1.5224205198,480873594
WC022,396721818,0,401861435,421194579,79349191,26036762,27244527,132630480,23937574,31040562,24469505,79447641,34249307,27727726,32980139,94957172,34286296,32039611,26727108,93053015,400088308,401861435,-1773127,-0.4412284548,421194579
WC023,1489943068,0,1511798367,1567203091,430776281,90424665,100164858,621365804,82483698,84863886,91185354,258532938,87421653,90054963,110001418,287478034,112134613,97237544,82976140,292348297,1459725073,1511798367,-52073294,-3.4444602625,1567203091
WC024,1099040652,0,1056997841,1111606321,410356077,40602536,58701994,509660607,54595487,50355938,75389625,180341050,48891598,66775651,76775651,192442900,56394516,56028792,59458664,171881972,1054326529,1056997841,-2671312,-0.252726344,1111606321
WC025,723383192,0,705383332,765080347,53363030,54993512,48812335,157168877,55991317,55755235,55822215,167568767,68878054,59072323,92791072,220741449,46846800,48581797,57162429,152591026,698070119,705383332,-7313213,-1.0367714501,765080347
WC026,437086338,0,478863260,489634823,71546561,29118961,27878001,128543523,27176863,49312461,34455084,110944408,33147209,37897734,54620517,125665460,38234617,31257991,28309242,97801850,462955241,478863260,-15908019,-3.3220379028,489634823
WC031,390322190,0,363906639,392712436,72494418,20596078,20873356,113963852,32112436,19932937,45212493,97257866,20727972,30621256,44289883,95639111,20903950,24290657,26257259,71451866,378312695,363906637,14406058,3.9587236217,392712436
WC032,748917475,0,786607982,812401925,82999602,61724343,61494213,206218158,60413300,77360820,61609414,199383534,67638717,60414177,75750165,203803059,59877878,59234810,86184243,205296931,814701682,784473899,30227783,3.853255416,812401925
WC033,205222683,0,218845070,230104066,61441794,9943670,11503253,82888717,12086174,10888386,17384980,40359540,32889065,10690224,20719072,64298361,10782247,16003651,11679806,38465704,226012322,222610378,3401944,1.528205482,230104066
WC034,192146730,0,185216329,207813284,45818780,8224562,8724385,62767727,13994093,21356963,15111394,50462450,9261897,7606864,14359782,31228543,18225413,8621279,12464819,39311511,183770231,185216336,-1446105,-0.780765364,207813284
WC041,120247700,0,114095510,114095510,21134568,6119470,2911764,30165802,5946094,5992821,4065354,16004269,4885202,5156639,6607214,16649055,4338112,7115463,4070016,15523591,78342717,114095513,-35752796,-31.3358475368,114095510
WC042,313750138,0,308082179,339101885,98150675,13084218,14727680,125962573,16785495,17109517,26804388,60699400,20867417,19217320,33283007,73367744,17427426,16870319,23357369,57655114,317684831,308082179,9602652,3.116912517,339101885
WC043,819824365,0,765886639,779872717,215849673,44434095,51260183,311543951,55330682,41913683,51828515,149072880,46476179,63825451,52539991,162841621,46791187,46543633,72212702,165547522,789005974,761386640,27619334,3.6275044175,779872717
WC044,1241482922,0,1156994737,1217776622,80581869,102729655,94685807,277997331,75942187,78502056,107495305,261939548,112347309,83843812,115709063,311900184,82389730,67378629,88496724,238265083,1090102146,1149244886,-59142740,-5.146226076,1217776622
WC045,393842390,0,461276953,461276953,146672210,19752220,20607759,187032189,21430029,19838475,35552514,76821018,23300590,20427711,39380356,83108657,22167124,20968756,19033313,62169193,409131057,461277339,-52146282,-11.3047569415,461276953
WC047,0,0,446663635,501265606,181684773,34649471,14309297,230643541,17412257,28153858,17075464,62641579,25854256,27702401,35535130,89091787,22736472,26586945,14222538,63545955,445922862,446663635,-740773,-0.1658458271,501265606
WC048,558914961,0,536766440,616512560,245820742,25813623,22244079,293878444,23679095,26096991,29229211,79005297,33139468,24209411,40534301,97883180,25518568,27764496,34969939,88253003,559019924,536766440,22253484,4.1458411595,616512560
WC051,0,0,40932200,39696787,9810302,3315765,3015775,16141842,2354174,7463071,679313,10496558,2659567,2382177,5176434,10218178,2081699,1811454,1901360,5794513,42651091,40863500,1787591,4.374542073,39696787
WC052,53769842,0,52367647,55300991,8535709,2329677,2546670,13412056,3695049,3242107,19540546,26477702,-1617823,-4525196,5842711,-300308,2206388,3879352,3456196,9541936,49131386,52367652,-3236266,-6.1798951765,55300991
WC053,237415297,0,232294785,255165909,48638950,12790618,10211167,71640735,13051270,10533682,22266289,45851241,16903737,10248096,19812940,46964773,10146811,19667912,11601137,41415860,205872609,232124785,-26252176,-11.3095100982,255165909
